{
    "F": 15,
    "H": 17,
    "T": 29,
    "5": 5,
    "A": 10,
    "I": 18,
    "M": 22,
    "3": 3,
    "0": 0,
    "P": 25,
    "U": 30,
    "R": 27,
    "V": 31,
    "1": 1,
    "9": 9,
    "K": 20,
    "8": 8,
    "C": 12,
    "E": 14,
    "Y": 34,
    "W": 32,
    "7": 7,
    "N": 23,
    "4": 4,
    "G": 16,
    "X": 33,
    "D": 13,
    "6": 6,
    "B": 11,
    "2": 2,
    "L": 21,
    "Q": 26,
    "J": 19,
    "S": 28,
    "O": 24,
    "Z": 35
}