{
    "3": 3,
    "U": 30,
    "S": 28,
    "V": 31,
    "A": 10,
    "P": 25,
    "B": 11,
    "9": 9,
    "E": 14,
    "6": 6,
    "2": 2,
    "F": 15,
    "M": 22,
    "J": 19,
    "7": 7,
    "X": 33,
    "4": 4,
    "Z": 35,
    "D": 13,
    "0": 0,
    "K": 20,
    "1": 1,
    "G": 16,
    "Q": 26,
    "Y": 34,
    "H": 17,
    "R": 27,
    "L": 21,
    "T": 29,
    "O": 24,
    "8": 8,
    "N": 23,
    "W": 32,
    "5": 5,
    "I": 18,
    "C": 12
}