{
    "G": 16,
    "Z": 35,
    "4": 4,
    "B": 11,
    "Q": 26,
    "P": 25,
    "W": 32,
    "0": 0,
    "J": 19,
    "S": 28,
    "A": 10,
    "O": 24,
    "9": 9,
    "H": 17,
    "5": 5,
    "L": 21,
    "K": 20,
    "6": 6,
    "V": 31,
    "D": 13,
    "I": 18,
    "M": 22,
    "Y": 34,
    "C": 12,
    "8": 8,
    "X": 33,
    "E": 14,
    "U": 30,
    "3": 3,
    "R": 27,
    "2": 2,
    "7": 7,
    "T": 29,
    "1": 1,
    "N": 23,
    "F": 15
}