{
    "7": 7,
    "8": 8,
    "X": 33,
    "Q": 26,
    "R": 27,
    "4": 4,
    "Y": 34,
    "W": 32,
    "D": 13,
    "Z": 35,
    "O": 24,
    "I": 18,
    "3": 3,
    "U": 30,
    "T": 29,
    "V": 31,
    "G": 16,
    "5": 5,
    "J": 19,
    "0": 0,
    "H": 17,
    "9": 9,
    "P": 25,
    "6": 6,
    "M": 22,
    "1": 1,
    "E": 14,
    "K": 20,
    "2": 2,
    "N": 23,
    "S": 28,
    "B": 11,
    "L": 21,
    "A": 10,
    "F": 15,
    "C": 12
}