{
    "0": 0,
    "O": 24,
    "R": 27,
    "D": 13,
    "7": 7,
    "I": 18,
    "2": 2,
    "F": 15,
    "P": 25,
    "G": 16,
    "3": 3,
    "9": 9,
    "8": 8,
    "T": 29,
    "V": 31,
    "U": 30,
    "E": 14,
    "4": 4,
    "L": 21,
    "N": 23,
    "A": 10,
    "C": 12,
    "M": 22,
    "1": 1,
    "K": 20,
    "5": 5,
    "S": 28,
    "B": 11,
    "6": 6,
    "J": 19,
    "Z": 35,
    "Q": 26,
    "H": 17,
    "W": 32,
    "X": 33,
    "Y": 34
}