{
    "M": 22,
    "2": 2,
    "Q": 26,
    "O": 24,
    "U": 30,
    "Y": 34,
    "L": 21,
    "R": 27,
    "D": 13,
    "T": 29,
    "K": 20,
    "N": 23,
    "1": 1,
    "7": 7,
    "6": 6,
    "9": 9,
    "J": 19,
    "E": 14,
    "I": 18,
    "8": 8,
    "F": 15,
    "B": 11,
    "Z": 35,
    "4": 4,
    "H": 17,
    "G": 16,
    "A": 10,
    "X": 33,
    "C": 12,
    "0": 0,
    "W": 32,
    "P": 25,
    "S": 28,
    "V": 31,
    "5": 5,
    "3": 3
}