{
    "6": 6,
    "V": 31,
    "B": 11,
    "1": 1,
    "Q": 26,
    "5": 5,
    "Y": 34,
    "2": 2,
    "E": 14,
    "4": 4,
    "W": 32,
    "Z": 35,
    "G": 16,
    "9": 9,
    "R": 27,
    "H": 17,
    "X": 33,
    "C": 12,
    "N": 23,
    "P": 25,
    "3": 3,
    "U": 30,
    "T": 29,
    "M": 22,
    "O": 24,
    "S": 28,
    "8": 8,
    "L": 21,
    "F": 15,
    "A": 10,
    "J": 19,
    "I": 18,
    "D": 13,
    "0": 0,
    "7": 7,
    "K": 20
}