{
    "X": 33,
    "H": 17,
    "K": 20,
    "G": 16,
    "N": 23,
    "0": 0,
    "V": 31,
    "5": 5,
    "T": 29,
    "Y": 34,
    "W": 32,
    "8": 8,
    "B": 11,
    "R": 27,
    "A": 10,
    "4": 4,
    "F": 15,
    "I": 18,
    "S": 28,
    "6": 6,
    "9": 9,
    "1": 1,
    "P": 25,
    "3": 3,
    "7": 7,
    "Q": 26,
    "E": 14,
    "C": 12,
    "O": 24,
    "2": 2,
    "M": 22,
    "D": 13,
    "J": 19,
    "Z": 35,
    "U": 30,
    "L": 21
}