{
    "Q": 26,
    "1": 1,
    "J": 19,
    "7": 7,
    "P": 25,
    "0": 0,
    "H": 17,
    "X": 33,
    "R": 27,
    "3": 3,
    "8": 8,
    "9": 9,
    "G": 16,
    "U": 30,
    "4": 4,
    "K": 20,
    "2": 2,
    "D": 13,
    "Y": 34,
    "I": 18,
    "V": 31,
    "O": 24,
    "W": 32,
    "E": 14,
    "C": 12,
    "S": 28,
    "5": 5,
    "F": 15,
    "B": 11,
    "N": 23,
    "L": 21,
    "Z": 35,
    "A": 10,
    "M": 22,
    "T": 29,
    "6": 6
}