{
    "9": 9,
    "7": 7,
    "4": 4,
    "I": 18,
    "3": 3,
    "G": 16,
    "1": 1,
    "N": 23,
    "D": 13,
    "K": 20,
    "8": 8,
    "W": 32,
    "Y": 34,
    "0": 0,
    "A": 10,
    "E": 14,
    "F": 15,
    "6": 6,
    "P": 25,
    "J": 19,
    "C": 12,
    "T": 29,
    "H": 17,
    "2": 2,
    "X": 33,
    "R": 27,
    "S": 28,
    "Z": 35,
    "M": 22,
    "V": 31,
    "B": 11,
    "L": 21,
    "5": 5,
    "O": 24,
    "U": 30,
    "Q": 26
}