{
    "V": 31,
    "5": 5,
    "L": 21,
    "1": 1,
    "X": 33,
    "U": 30,
    "E": 14,
    "G": 16,
    "Y": 34,
    "N": 23,
    "K": 20,
    "C": 12,
    "D": 13,
    "J": 19,
    "R": 27,
    "T": 29,
    "P": 25,
    "7": 7,
    "A": 10,
    "H": 17,
    "Z": 35,
    "Q": 26,
    "I": 18,
    "4": 4,
    "2": 2,
    "3": 3,
    "S": 28,
    "O": 24,
    "8": 8,
    "W": 32,
    "9": 9,
    "M": 22,
    "6": 6,
    "0": 0,
    "B": 11,
    "F": 15
}