{
    "V": 31,
    "Y": 34,
    "A": 10,
    "K": 20,
    "5": 5,
    "6": 6,
    "0": 0,
    "M": 22,
    "Z": 35,
    "8": 8,
    "T": 29,
    "9": 9,
    "H": 17,
    "1": 1,
    "B": 11,
    "X": 33,
    "W": 32,
    "7": 7,
    "O": 24,
    "E": 14,
    "D": 13,
    "L": 21,
    "J": 19,
    "N": 23,
    "I": 18,
    "R": 27,
    "3": 3,
    "S": 28,
    "C": 12,
    "Q": 26,
    "U": 30,
    "F": 15,
    "G": 16,
    "P": 25,
    "2": 2,
    "4": 4
}