{
    "0": 0,
    "H": 17,
    "K": 20,
    "Y": 34,
    "R": 27,
    "Z": 35,
    "4": 4,
    "N": 23,
    "5": 5,
    "D": 13,
    "7": 7,
    "V": 31,
    "P": 25,
    "W": 32,
    "B": 11,
    "M": 22,
    "O": 24,
    "I": 18,
    "U": 30,
    "S": 28,
    "C": 12,
    "9": 9,
    "L": 21,
    "T": 29,
    "A": 10,
    "6": 6,
    "E": 14,
    "2": 2,
    "1": 1,
    "8": 8,
    "G": 16,
    "X": 33,
    "F": 15,
    "3": 3,
    "Q": 26,
    "J": 19
}