{
    "X": 33,
    "R": 27,
    "4": 4,
    "V": 31,
    "S": 28,
    "W": 32,
    "1": 1,
    "3": 3,
    "C": 12,
    "N": 23,
    "7": 7,
    "2": 2,
    "L": 21,
    "I": 18,
    "G": 16,
    "O": 24,
    "5": 5,
    "T": 29,
    "Q": 26,
    "8": 8,
    "P": 25,
    "6": 6,
    "D": 13,
    "B": 11,
    "J": 19,
    "K": 20,
    "U": 30,
    "F": 15,
    "0": 0,
    "Y": 34,
    "9": 9,
    "A": 10,
    "H": 17,
    "Z": 35,
    "E": 14,
    "M": 22
}