{
    "I": 18,
    "2": 2,
    "1": 1,
    "Q": 26,
    "Y": 34,
    "E": 14,
    "4": 4,
    "K": 20,
    "8": 8,
    "G": 16,
    "B": 11,
    "D": 13,
    "H": 17,
    "U": 30,
    "V": 31,
    "6": 6,
    "T": 29,
    "N": 23,
    "X": 33,
    "M": 22,
    "W": 32,
    "S": 28,
    "3": 3,
    "A": 10,
    "5": 5,
    "Z": 35,
    "L": 21,
    "P": 25,
    "7": 7,
    "9": 9,
    "F": 15,
    "C": 12,
    "O": 24,
    "R": 27,
    "J": 19,
    "0": 0
}