{
    "J": 19,
    "R": 27,
    "5": 5,
    "O": 24,
    "B": 11,
    "X": 33,
    "K": 20,
    "1": 1,
    "I": 18,
    "P": 25,
    "7": 7,
    "T": 29,
    "F": 15,
    "S": 28,
    "U": 30,
    "L": 21,
    "G": 16,
    "3": 3,
    "Z": 35,
    "C": 12,
    "9": 9,
    "V": 31,
    "W": 32,
    "Q": 26,
    "A": 10,
    "8": 8,
    "D": 13,
    "2": 2,
    "M": 22,
    "0": 0,
    "Y": 34,
    "E": 14,
    "4": 4,
    "H": 17,
    "N": 23,
    "6": 6
}