{
    "N": 23,
    "Q": 26,
    "G": 16,
    "V": 31,
    "O": 24,
    "U": 30,
    "Z": 35,
    "2": 2,
    "Y": 34,
    "4": 4,
    "D": 13,
    "X": 33,
    "W": 32,
    "L": 21,
    "3": 3,
    "I": 18,
    "A": 10,
    "1": 1,
    "H": 17,
    "M": 22,
    "B": 11,
    "K": 20,
    "S": 28,
    "0": 0,
    "C": 12,
    "J": 19,
    "F": 15,
    "7": 7,
    "E": 14,
    "T": 29,
    "8": 8,
    "9": 9,
    "R": 27,
    "6": 6,
    "5": 5,
    "P": 25
}