{
    "K": 20,
    "9": 9,
    "2": 2,
    "R": 27,
    "U": 30,
    "7": 7,
    "G": 16,
    "P": 25,
    "L": 21,
    "J": 19,
    "M": 22,
    "1": 1,
    "5": 5,
    "F": 15,
    "N": 23,
    "I": 18,
    "0": 0,
    "O": 24,
    "H": 17,
    "W": 32,
    "6": 6,
    "X": 33,
    "Z": 35,
    "C": 12,
    "A": 10,
    "S": 28,
    "3": 3,
    "V": 31,
    "4": 4,
    "D": 13,
    "Q": 26,
    "B": 11,
    "Y": 34,
    "E": 14,
    "T": 29,
    "8": 8
}