{
    "4": 4,
    "Z": 35,
    "Y": 34,
    "7": 7,
    "O": 24,
    "E": 14,
    "R": 27,
    "0": 0,
    "I": 18,
    "A": 10,
    "M": 22,
    "V": 31,
    "W": 32,
    "L": 21,
    "3": 3,
    "N": 23,
    "K": 20,
    "9": 9,
    "G": 16,
    "T": 29,
    "F": 15,
    "2": 2,
    "5": 5,
    "B": 11,
    "8": 8,
    "D": 13,
    "C": 12,
    "U": 30,
    "1": 1,
    "6": 6,
    "S": 28,
    "Q": 26,
    "J": 19,
    "P": 25,
    "H": 17,
    "X": 33
}