{
    "5": 5,
    "6": 6,
    "4": 4,
    "D": 13,
    "K": 20,
    "R": 27,
    "M": 22,
    "C": 12,
    "L": 21,
    "9": 9,
    "H": 17,
    "E": 14,
    "G": 16,
    "F": 15,
    "1": 1,
    "T": 29,
    "X": 33,
    "2": 2,
    "N": 23,
    "P": 25,
    "A": 10,
    "3": 3,
    "0": 0,
    "J": 19,
    "B": 11,
    "Q": 26,
    "8": 8,
    "S": 28,
    "W": 32,
    "U": 30,
    "O": 24,
    "7": 7,
    "Y": 34,
    "V": 31,
    "I": 18,
    "Z": 35
}