{
    "5": 5,
    "8": 8,
    "E": 14,
    "Q": 26,
    "7": 7,
    "M": 22,
    "U": 30,
    "S": 28,
    "F": 15,
    "6": 6,
    "2": 2,
    "O": 24,
    "G": 16,
    "C": 12,
    "B": 11,
    "H": 17,
    "N": 23,
    "A": 10,
    "R": 27,
    "I": 18,
    "D": 13,
    "X": 33,
    "3": 3,
    "Z": 35,
    "1": 1,
    "P": 25,
    "4": 4,
    "W": 32,
    "J": 19,
    "Y": 34,
    "0": 0,
    "T": 29,
    "9": 9,
    "K": 20,
    "L": 21,
    "V": 31
}