{
    "A": 10,
    "5": 5,
    "B": 11,
    "X": 33,
    "I": 18,
    "R": 27,
    "D": 13,
    "P": 25,
    "3": 3,
    "M": 22,
    "0": 0,
    "Y": 34,
    "S": 28,
    "T": 29,
    "Q": 26,
    "6": 6,
    "J": 19,
    "G": 16,
    "V": 31,
    "W": 32,
    "1": 1,
    "F": 15,
    "K": 20,
    "E": 14,
    "9": 9,
    "N": 23,
    "4": 4,
    "L": 21,
    "H": 17,
    "7": 7,
    "U": 30,
    "O": 24,
    "2": 2,
    "Z": 35,
    "C": 12,
    "8": 8
}