{
    "G": 16,
    "A": 10,
    "T": 29,
    "J": 19,
    "7": 7,
    "3": 3,
    "8": 8,
    "M": 22,
    "Z": 35,
    "X": 33,
    "H": 17,
    "Y": 34,
    "N": 23,
    "P": 25,
    "I": 18,
    "L": 21,
    "4": 4,
    "S": 28,
    "O": 24,
    "B": 11,
    "2": 2,
    "W": 32,
    "5": 5,
    "9": 9,
    "U": 30,
    "Q": 26,
    "0": 0,
    "F": 15,
    "6": 6,
    "E": 14,
    "D": 13,
    "C": 12,
    "1": 1,
    "R": 27,
    "V": 31,
    "K": 20
}