{
    "G": 16,
    "F": 15,
    "U": 30,
    "W": 32,
    "Q": 26,
    "X": 33,
    "R": 27,
    "9": 9,
    "3": 3,
    "I": 18,
    "N": 23,
    "L": 21,
    "8": 8,
    "Z": 35,
    "4": 4,
    "1": 1,
    "C": 12,
    "P": 25,
    "0": 0,
    "D": 13,
    "V": 31,
    "K": 20,
    "2": 2,
    "E": 14,
    "A": 10,
    "O": 24,
    "6": 6,
    "H": 17,
    "S": 28,
    "M": 22,
    "Y": 34,
    "J": 19,
    "T": 29,
    "7": 7,
    "B": 11,
    "5": 5
}