{
    "6": 6,
    "1": 1,
    "G": 16,
    "D": 13,
    "H": 17,
    "C": 12,
    "A": 10,
    "X": 33,
    "I": 18,
    "R": 27,
    "Q": 26,
    "E": 14,
    "0": 0,
    "L": 21,
    "U": 30,
    "O": 24,
    "N": 23,
    "F": 15,
    "J": 19,
    "S": 28,
    "B": 11,
    "5": 5,
    "3": 3,
    "8": 8,
    "2": 2,
    "Y": 34,
    "V": 31,
    "T": 29,
    "4": 4,
    "Z": 35,
    "P": 25,
    "K": 20,
    "9": 9,
    "M": 22,
    "7": 7,
    "W": 32
}