{
    "1": 1,
    "0": 0,
    "S": 28,
    "W": 32,
    "Z": 35,
    "F": 15,
    "2": 2,
    "E": 14,
    "7": 7,
    "X": 33,
    "K": 20,
    "Q": 26,
    "3": 3,
    "B": 11,
    "Y": 34,
    "U": 30,
    "4": 4,
    "H": 17,
    "R": 27,
    "9": 9,
    "V": 31,
    "6": 6,
    "O": 24,
    "G": 16,
    "J": 19,
    "M": 22,
    "L": 21,
    "C": 12,
    "P": 25,
    "T": 29,
    "5": 5,
    "A": 10,
    "D": 13,
    "8": 8,
    "N": 23,
    "I": 18
}