{
    "D": 13,
    "V": 31,
    "N": 23,
    "A": 10,
    "J": 19,
    "2": 2,
    "6": 6,
    "1": 1,
    "L": 21,
    "W": 32,
    "P": 25,
    "Q": 26,
    "R": 27,
    "X": 33,
    "7": 7,
    "C": 12,
    "3": 3,
    "S": 28,
    "U": 30,
    "Y": 34,
    "9": 9,
    "O": 24,
    "5": 5,
    "B": 11,
    "F": 15,
    "T": 29,
    "E": 14,
    "I": 18,
    "Z": 35,
    "M": 22,
    "K": 20,
    "G": 16,
    "4": 4,
    "H": 17,
    "0": 0,
    "8": 8
}